NODE: 01- 000: 000- 02: 03: 04 ;
NODE: 02- 000: 000- 01: 05: 07 ;
NODE: 03- 000: 000- 01: 04 ;
NODE: 04- 000: 000- 01: 03: 06 ;
NODE: 05- 000: 000- 02: 06: 07 ;
NODE: 06- 000: 000- 04: 05: 08 ;
NODE: 07- 000: 000- 02: 05: 10 ;
NODE: 08- 000: 000- 06: 09: 10 ;
NODE: 09- 000: 000- 08: 10 ;
NODE: 10- 000: 000- 07: 08: 09 ;