NODE: 01- 000: 000- 02: 03 ;
NODE: 02- 000: 000- 01: 04 ;
NODE: 03- 000: 000- 01: 04 ;
NODE: 04- 000: 000- 02: 03: 05: 06 ;
NODE: 05- 000: 000- 04: 07 ;
NODE: 06- 000: 000- 04: 07 ;
NODE: 07- 000: 000- 05: 06: 08: 09 ;
NODE: 08- 000: 000- 07: 10 ;
NODE: 09- 000: 000- 07: 10 ;
NODE: 10- 000: 000- 08: 09 ;